########
#     .#
#   $$.#
###    #
  ##@ ##
   ####